###############################
#___e__________e______________#
#_____####*_____####___#______#
#____###_______###_____#______#
#_____###_______#*_____#______#
#_______#_______#___e__#___####
#___*______###*________##_____#
#_____e__________###__________#
#_______##___*________________#
######______###_______##______#
#_____________________________#
#________________T____________#
###############################