###############################
#e________________*__________e#
#_______########_#######______#
#_______#______________#______#
#___*___#______________#__*___#
#_______#________T_____#______#
#_______#______________#______#
#_______################______#
#_____________________________#
#_______________*_____________#
#_____________________________#
#e___________________________e#
###############################