###############################
#*___________________________*#
#_______####_______####_______#
#______#_e__#_____#_e__#______#
#______#_____#___#_____#______#
#*______##___________##______*#
#_________#____T____#_________#
#__________##_____##__________#
#____________#___#____________#
#_____________#_#_____________#
#______________#______________#
#e_____________e_____________e#
###############################