###############################
#_________e_____________e_____#
#__*__________________________#
#_____#*____#####____#________#
#____#__#____*#______#__e_____#
#____#e_#__e__#______#________#
#____#__#_____#______#________#
#____#__#_____#______#________#
#_____##______#______####_____#
#___e_________________________#
#_____________________________#
#____________________________T#
###############################