###############################
#______e__________e___________#
#_###########################_#
#_#_________________________#_#
#_#_#######################_#e#
#_#_#_____________________#_#_#
#_#_#_###################_#_#_#
#e#_#_#T__________________#_#_#
#_#_#_#####################_#e#
#_#_#_______________________#_#
#_#_#########################_#
#____________________________e#
###############################