###############################
#__e__#_______#_______#_______#
#___*___*_____#_____*___*_e___#
#_____#___e___#_______#_______#
#_____#_______#_______#_______#
#_____#_______#_______#_______#
#_____#_______#_______#_______#
#_____#_______#_______#_______#
#_____#_______#____e__#_______#
#_____#___e___#_______#_______#
#__e__#_____*___*_____#_______#
#_____#_______#_______#______T#
###############################