###############################
#__###_______________#________#
#___e#_____*_________#e_______#
#____#_______________####__*__#
#_____e_______#_______________#
#__#####___#######____________#
#_____*______e#____####e___*__#
#_____________#_______*_______#
###_####___*_________#________#
#______#_______#_____#_____####
#______________#e____#_____e__#
#T_____#_______#______________#
###############################