###############################
#eeeeeeeeeeeeeeeeeeeeeeeeeeeee#
#****************************e#
#___________________________*e#
#___________________________*e#
#___________________________*e#
#___________________________*e#
#___________________________*e#
#___________________________*e#
#___________________________*e#
#___________________________*e#
#T__________________________*e#
###############################